@@@@@@@@@
@       @
@ @@ @@ @@@
@ @   @   @
@ @@@ @ @ @
@     @ @ @
@ @@@@@ @ @
@       @@@
@@@@@@@@@
